0 0 0 0 0 0 0
0 0 1 0 0 0 0
0 0 2 3 0 0 0
0 0 0 4 5 0 0
0 0 0 0 0 0 0
0 0 0 0 0 0 0
0 0 0 0 0 0 0
