0 0 0 0 0 0 0 
1 0 5 0 0 0 0 
2 3 4 0 0 0 0 
0 0 0 0 0 0 0 
0 0 0 0 0 0 0 
0 0 0 0 0 0 0 
0 0 0 0 0 0 0 
