0 0 0 0 0 0 0 
0 0 0 0 0 0 0 
0 0 0 0 0 0 0 
0 0 0 4 3 2 1 
0 0 0 5 0 0 0 
0 0 0 0 0 0 0 
0 0 0 0 0 0 0 
